111111111111111111111111111111111111
11         1                      11
11                                11
11            1           1       11
11                                11
11                                11
11                                11
1111   11111   1   1   111111   1111
11           1 1 1 1 1            11
11                                11
11                                11
11                                11
1111   111    33   44   111     1111
11                                11
11                                11
11              111               11
11                                11
1111        22       22         1111
11            22   22             11
11             22222              11
11                                11
11                                11
1111                            1111
11                                11
11                                11
11                                11
11                                11
111111111111111111111111111111111111
